                                                                                                    
                                                                                                    
                                                                                                    
                                                                                                    
                                                                                                    
                                                                                                    
                                                                                                    
                       IIIIII                                                                       
                       77I7 7                                                                       
                         I                                                                          
                     I   I  3                                                                       
                     II  I                                                                          
                     I  II   3                                                                      
        1       1       I                                                                           
       EF  EBBBBF       I                                                                           
       CHBBGAMLLJ    IIIIIII I                                                                      
      EGAMLLLJ       I                                                                              
      KLLJ7          I                                                                              
     1              II                                                                              
BF   EBBBF      2  II     1                                                                         
AD   CAAAD  EF     I     EBBBF                                                                      
AD3  CAAAD  KJ     I     CAAAD                                                                      
AD   CAMLJ         I 1   KLLLJ                                                                      
MJ   KLJ        2  EBBBF                                                                            
D    1             KLLLJIIII I                                                                      
D EBBBBBBBBBF          I                                                                            
D KLLLLLLLLLJIII3      I  2                                                                         
D                      I                                                                            
J P                    I     *                                                                      
  EBBF5       EBF    EBF   EBB                                                                      
